 8  9  9  9  9  9  9  9  9  9  9  9  9  9  9  9  9  9  9 10 
24 25 25 25 25 25 25 25 25 25 25 25 25 25 25 25 25 25 25 26 
179 212 212 212 212 212 212 212 212 212 212 212 212 212 212 212 212 212 212 180 
195 48 49 49 49 51 51 51 51 51 51 51 51 51 51 49 49 49 50 195 
195 64 65 65 66 197 176 177 177 177 177 177 177 178 197 64 65 65 66 195 
195 64 65 65 66 195 192 193 193 193 193 193 193 194 195 64 65 65 66 195 
195 64 65 65 66 195 192 193 193 193 193 193 193 194 195 64 65 65 66 195 
195 64 65 65 66 195 192 193 193 193 193 193 193 194 195 64 65 65 66 195 
195 64 65 65 66 195 192 193 193 193 193 193 193 194 195 64 65 65 66 195 
195 64 65 65 66 195 192 193 193 193 193 193 193 194 195 64 65 65 66 195 
195 64 65 65 66 195 208 209 209 209 209 209 209 210 195 64 65 65 66 195 
195 80 81 81 82 211 180  0  1  1  1  1  2 179 213 64 65 65 66 195 
195 96 97 97 97 98 195 16 17 17 17 36 18 195 48 65 65 65 66 195 
195 112 113 113 113 114 195 16 20 17 17 17 18 195 64 65 65 65 66 195 
195 128 129 129 129 130 195 16 17 17 17 17 18 195 80 81 81 81 82 195 
211 212 212 212 212 212 213 16 17 36 17 17 18 211 212 212 212 212 212 213 
