193 112 113 113 113 113 16 17 17 195 22 17  8  9 10 17 22 112 113 113 
193 112 113 162 113 113 32 17 17 195 22 20 24 25 26 36 22 112 113 113 
193 128 129 129 145 113 113 16 17 195 22 17 40 41 40 17 22 112 113 113 
193 193 193 193 112 162 113 16 17 195 22 20 36 195 17 17 22 112 113 113 
193 193 193 96 161 113 113 16 17 195 22 22 22 195 22 22 22 112 113 113 
193 193 193 112 113  5 113 16 17 195 17 17 17 195 17 17 17 112 113 113 
193 193 193 112 113 113 113 16 17 211 212 212 212 213 17 17 17 112 113 113 
193 193 193 112 162 162  0 17 17 20 17 17 17 17 17 17 17 112 113 113 
97 97 97 161 113  0 17 17 17 17 17 17 17 17 17 17 17 112 113 113 
113 162 113 146 113 16 36 17 20 17 17 17 17 17 17 17 17 112 113 113 
113 113 113 162 113 16 17 17 17 17 17 17 17 96 97 97 97 161 113 113 
 1  1  1  1  1 17 20 17 17 17 36 17 17 112 146 146 146 146 146 146 
17 17 17 17 17 17 17 17 17 17 17 17 17 112 146 146 72 73 146 146 
17 36 17 17 17 36 17 17 17 17 17 17 17 112 146 146 88 89 146 146 
17 17 17 17 17 17 17 17 17 20 17 17 96 161 146 146 146 146  5 146 
17 17 17 17 17 17 17 17 17 17 17 17 112 146 146 146 146 146 146 146 
