33 33 33 33 33 33 34 21 21 21 32  6  6  6  6  6  6  6  6  6 
33 33 33 41 41 33 33 25 26 21 32 33 33  6  6  6  6  6  6  6 
33 33 34 44 44 40 41 41 42 21 32 33 41 41 33  6  6  6  6  6 
 6 33 33 26 28 44 52 36 28 21 32 34 36 44 32 34 36 52  6  6 
 6  6  6 34 52 52 28 44 44 21 32 34 28 24 33 34 52 44  6  6 
 6  6  6  6  6  6 44 21 21 21 40 41 27 41 33 34 52 28 52 52 
21 21 21 21 21 21 21 21 44 44 44 28 28 52 32 33 26 52 44 44 
 6  6  6  6  6  6 44 44 44 36 44 52 52 52 40 33 33 26 52 36 
 6  6  6  6  6  6  6 26 44 44 52 36 44 44 44 32 33 33 25 25 
 6  6  6  6  6  6  6 34 44 28 44 52 52 44 44 40 33 33 33 33 
 6  6  6  6  6  6  6  6 25 25 26 52 28 52 44 28 32 33 33 33 
 6  6  6  6  6  6  6  6 33 33 33 26 52 52 44 44 32 33 33 41 
 6  6  6  6  6  6  6  6  6 33 33 33 26 36 44 44 32 33 42 52 
 6  6  6  6  6  6  6  6  6  6  6 33 33 26 52 24 33 42 52 44 
 6  6  6  6  6  6  6  6  6  6  6 33 33 33 25 33 34 44 44 36 
 6  6  6  6  6  6  6  6  6  6  6 33 33 33 33 33 34 28 28 44 
