177 177 177 177 177 177 177 177 177 177 177 177 177 177 177 177 177 177 177 178 
 17  17  34   4   4   5   4   3   4   4   4  16  17  17  17  17  17  17  17 194 
 33  34 179 212 212 212 212 212 212 212 212 212 212 212 212 212 212 180  17 194 
  4   4 195  84  84  48  51  51  51  51  51  51  51  51  51  49  49 195  17 194 
  4   5 195  48  50 197 176 177 177 177 177 177 177 178 197  64  65 195  17 194 
  4   4 195  64  66 195 192 193 193 193 193 193 193 194 195  64  65 195  17 194 
  4   4 195  80  66 195 192 193 193 193 193 193 193 194 195  64  65 195  17 194 
  4   4 195  84  67 195 192 193 193 193 193 193 193 194 195  80  82 195  17 194 
  4   5 195  84  67 195 192 193 193 193 193 193 193 194 195  84  84 195  17 194 
  4   4 195  48  66 195 192 193 193 193 193 193 193 194 195  84  84 195  32 194 
129 129 195  64  66 195 208 209 209 209 209 209 209 210 195  84  84 195   4 194 
193 193 195  64  66 211 180   4   4   0   1   1   2 179 213  84  84 195   4 194 
193 193 195  64  65  50 195   0   1  17  17  36  34 195  48  50  84 195   4 194 
193 193 195  64  65  66 195  16  20  17  17  18   5 195  80  82  84 195   4 194 
193 193 211 212 212 212 213  16  17  17  17  18   4 211 212 212 212 213   4 194 
193  96 161   4   4   4   4  16  17  36  17  18   4   4   4   4   4   4   4 194 
