65 65 81 82 68 64 37 64 65 65 82 84 100 100 84 84 52 52 64 65 
65 66 84 68 84 80 37 64 65 82 68 52 84 84 84 68 84 84 64 65 
65 82 100 84 52 68 37 80 82 68 52 100 84 52 100 68 84 84 64 65 
82 52 84 84 100 100 37 52 84 100 100 100 68 100 84 84 68 52 64  6 
22 68 84 84 100 52 37 52 48 49 49 50 100 84 84 84 48 49 65  6 
22 37 37 37 37 37 37 52 40 81 81 66 52 52 68 68 80 81  6  6 
22 52 100 100 100 100 37 37 37 37 37 65 49 51 49 50 37 37 37 37 
49 49 51 51 49 49 49 51 51 50 37 80 66 52 64 66 37  6  6  6 
65 66 84 68 64 81 66 100 52 67 37 68 64 49 65  6 37  6  6  6 
65 82 100 84 67 68 64 51 49 66 37 48 65 65  6  6 37  6  6  6 
66 84 84 84 80 49 66 84 64 66 37 64 65  6  6  6 37  6  6  6 
82 68 100 100 100 64 66 52 64 66 37  6  6  6  6  6 37  6  6  6 
84 52 100 52 100 64 65 49 65  6 37  6  6  6  6  6 37  6  6  6 
84 84 100 68 48 81 65 65  6  6 37  6  6  6  6 37 37  6  6  6 
100 100 84 52 67 84 64 65  6  6 37 37 37 37 37 37  6  6  6  6 
49 49 49 49 66 68 64  6  6  6  6  6  6  6  6  6  6  6  6  6 
