176 177 177 177 177 177 177 177 177 177 177 177 177 177 177 177 177 177 177 177 
192  33  33  33  17  18   4   4   5   4   4   4   4  16  17  17  17  17  17  17 
192   4   4   4  16  17   1   2   4   4   4   0   1  17  17  33  33  17  17  17 
192   5   4   4  16  17  17  17   1   1   1  17  17  33  34   4   4  16  17  17 
192   4   4   4  16  17  17  17  17  17  17  33  34   4   4   4   0  17  17  17 
192   4   0   1  17  17  17  33  33  33  34   4   4   4   4   4  32  33  33  33 
192   1  17  17  17  17  18  37  37  37  37  37  37  37  37  37  37  37  37  37 
192  21  21  21  21  21  21  37   0   2   4   4   4   4   4   0   1   1   1   1 
192  17  17  17  33  33  18  37  16  18   4   4   5   4   4  16  17  17  17  17 
192  17  17  18   4   4   3  37  16  17   2   4   4   4   0  22  22  22  22  17 
192  33  17  17   2   4   3  37  16  17  18   4   4   4  16  22  38  38  22  17 
192   4  32  17  17   1  34  37  16  17  17   1  19   1  17  22  38  38  22  17 
192   5   4  16  17  18  37  37  16  17  17  18   4  16  17  22  22  22  22  17 
192   4   4  16  33  34  37   4  16  17  17  18   4  16  17  33  33  33  33  17 
192   1   1  34   4   4  37   4  16  22  17  17  19  33  34   4   5   4   4  16 
192  17  18   4   5   4  37   0  17  17  17  18   4   4   4   4   4   4   4  16 
