65 65 65 65 65 65 66 37 37 37 64  6  6  6  6  6  6  6  6  6 
65 65 65 81 81 65 65 49 50 37 64 65 65  6  6  6  6  6  6  6 
65 65 66 84 84 80 81 81 82 37 64 65 81 81 65  6  6  6  6  6 
 6 65 65 50 52 84 100 68 52 37 64 66 68 84 64 66 68 100  6  6 
 6  6  6 66 100 100 52 84 84 37 64 66 52 48 65 66 100 84  6  6 
 6  6  6  6  6  6 84 37 37 37 80 81 51 81 65 66 100 52 100 100 
37 37 37 37 37 37 37 37 84 84 84 52 52 100 64 65 50 100 84 84 
 6  6  6  6  6  6 84 84 84 68 84 100 100 100 80 65 65 50 100 68 
 6  6  6  6  6  6  6 50 84 84 100 68 84 84 84 64 65 65 49 49 
 6  6  6  6  6  6  6 66 84 52 84 100 100 84 84 80 65 65 65 65 
 6  6  6  6  6  6  6  6 49 49 50 100 52 100 84 52 64 65 65 65 
 6  6  6  6  6  6  6  6 65 65 65 50 100 100 84 84 64 65 65 81 
 6  6  6  6  6  6  6  6  6 65 65 65 50 68 84 84 64 65 82 100 
 6  6  6  6  6  6  6  6  6  6  6 65 65 50 52 48 65 82 100 84 
 6  6  6  6  6  6  6  6  6  6  6 65 65 65 49 65 66 84 84 68 
 6  6  6  6  6  6  6  6  6  6  6 65 65 65 65 65 66 52 52 84 
