192  65  81  82  68  64  37  64  65  65  82  84 100 100  84  84  52  52  64  65 
192  66  84  68  84  80  37  64  65  82  68  52  84  84  84  68  84  84  64  65 
192  82 100  84  52  68  37  80  82  68  52 100  84  52 100  68  84  84  64  65 
192  52  84  84 100 100  37  52   8   9  10 100  68 100  84  84  68  52  64 193 
192  68  84  84 100  52  37  52  24  25  26  50 100  84  84  84  48  49  65 193 
192  37  37  37  37  37  37  52  40  41  40  22  52  52  68  68  80  81 193   6 
192  52 100 100 100 100  37  37  37  37  37  65  49  51  49  50  37  37  37  37 
192  49  51  51  49  49  49  51  51  50  37  80  66  52  64  66  37   6   6   6 
192  66  84  68  64  81  66 100  52  67  37  68  64  49  65 193  37   6   6   6 
192  82 100  84  67  68  64  51  49  66  37  48  65  65 193   6  37   6   6   6 
192  84  84  84  80  49  66  84  64  66  37  64  65 193   6   6  37   6   6   6 
192  68 100 100 100  64  66  52  64  66  37 193 193   6   6   6  37   6   6   6 
192  52 100  52 100  64  65  49  65 193  37   6   6   6   6   6  37   6   6   6 
192  84 100  68  48  81  65  65 193   6  37   6   6   6   6  37  37   6   6   6 
192 100  84  52  67  84  64  65 193   6  37  37  37  37  37  37   6   6   6   6 
192  49  49  49  66  68  64 193   6   6   6   6   6   6   6   6   6   6   6   6 
