177 177 177 177 177 177 177 177 177 177 177 177 177 177 177 177 177 177 177 177 
17 34  4  4  5 16 17 17 17 17 193  6 193 17 17 17 20 17 17 17 
18  5  4  5  0 17 36 17 20 193 193 193 193 17 33 33 33 33 33 17 
17  2  4  4 32 17 17 17 17 193 193 17 17 18  4  4  4  4  5 16 
17 17  1  2  4 16 17 17 193  6 193 17 20 18  4  5  4  4  4 16 
33 33 33 33 19 17 36 17 193  6 193 17 17 17  2  5  4  4  0 17 
37 37 37 37 37 16 17 20 17 193 193 20 17 17 17  1  2  5 16 17 
 1  1  1  2 37 16 17 17 17 193 193 17 38 38 38 17 17  1 17 17 
17 20 17 34 37 32 33 33 17 17 17 17 38 38 38 32 36 33 20 17 
17 33 34  4 37 37 37 37 16 17 20 17 38 38 38  4  4  4 32 33 
34  4  4  0  1  1  2 37 16 20 17 17 34  4  4  4 144 129 129 129 
 5  5  4 16 17 17 18 37 16 33 33 34  4  4  4 144 130 193 193 193 
 4  4  4 16 36 17 18 37  3  4  4  5  4 144 129 130 193  6  6  6 
 2  5  4 16 17 36 18 37  3  4  5  4 144 130 193 193  6  6  6  6 
18  4  5 16 17 17 18 37  3  4 144 129 130 193  6  6  6  6  6  6 
17  1  1 17 20 17 18 37 16  2 114 193 193  6  6  6  6  6  6  6 
