193 112 113 113 113 113  16  17  17  17  17  17  17  17  17  17  17 112   4   4 
193 112 113   5 113 113  32  17  17  17  21  21  21  21  21  21  21 112   4   4 
193 128 129 129 145   4 113  16  17  17  21  17  17  17  17  17  21 112   4   4 
193 193 193 193 112 162 113  16  17  17  21  20   8   9  10  17  21 112   4   4 
193 193 193  96 161 113 113  16  17  17  21  17  24  25  26  17  21 112   4   4 
193 193 193 112 113   5 113  16  17  17  21  17  40  41  40  17  21 112  72  73 
193 193 193 112 113 113 113  16  17  17  21  17  18  37  16  17  21 112  88  89 
193 193 193 112 162 162   0  17  33  20  21  21  21  37  21  21  21 112 113 113 
 97  97  97 161 113   0  17  18  37  37  37  37  37  37  16  17  17 112 113 113 
  4   4 113   5 113  16  36  18  37   0   1   1   1   1  17  17  17 112 113 113 
113 113 113 162 113  16  17  18  37  16  17  17  17  96  97  97  97 161 113 113 
  1   1   1   1   1  17  20  18  37  16  36  17  17 112 146 146 146 146 146 146 
 17  17  17  17  17  17  17  18  37  16  17  17  17 112 146 146  72  73  72  73 
 33  36  33  33  33  36  33  34  37  16  17  17  17 112 146 146  88  89  88  89 
 37  37  37  37  37  37  37  37  37  20  17  17  96 161 146 146 146 146   5 146 
  1   1   1   1   1   1   1   1   1  17  17  17 112 146  72  73 146 146 146 146 
