257 248 249 248 248 248 249 248 248 248 248 248 249 248 256 257 248 248 248 256 
273 294 294 294 294 294 294 294 294 294 294 294 294 294 272 273 293 293 296 272 
273 294 279 294 294 294 294 294 294 294 294 294 279 294 272 273 293 293 293 272 
273 294 294 294 294 294 294 294 294 294 294 294 294 294 272 266 232 226 227 270 
273 294 294 294 294 294 294 294 294 294 294 294 294 294 298 248 248 242 243 256 
273 294 294 294 294 294 294 294 294 294 294 294 294 294 294 294 294 294 294 272 
273 294 294 294 294 294 294 294 294 294 294 294 294 294 294 294 294 294 294 272 
273 294 294 294 294 294 294 294 294 294 294 294 294 294 294 294 294 294 294 272 
273 294 279 294 294 294 294 294 294 294 294 294 279 294 294 294 294 294 294 272 
250 294 294 294 294 294 294 294 294 294 294 294 294 294 294 294 294 294 294 298 
265 265 265 265 265 265 265 265 265 265 265 265 265 265 265 265 265 265 265 265 
287 287 287 287 287 287 287 287 287 287 287 287 287 287 287 287 287 287 287 287 
287 287 287 287 287 287 287 287 287 287 287 287 287 287 287 287 287 287 287 287 
287 287 287 287 287 287 287 287 287 287 287 287 287 287 287 287 287 287 287 287 
287 287 287 287 287 287 287 287 287 287 287 287 287 287 287 287 287 287 287 287 
287 287 287 287 287 287 287 287 287 287 287 287 287 287 287 287 287 287 287 287 
