33 33 41 42 36 32 21 32 33 33 42 44 52 52 44 44 28 28 32 33 
33 34 44 36 44 40 21 32 33 42 36 28 44 44 44 36 44 44 32 33 
33 42 52 44 28 36 21 40 42 36 28 52 44 28 52 36 44 28 32 33 
42 28 44 44 52 52 21 52 44 52 52 52 36 52 44 44 36 24 33  6 
14 36 44 44 52 28 21 52 24 25 25 26 52 44 44 44 24 33 33  6 
14 21 21 21 21 21 21 52 40 41 41 34 28 28 36 36 40 41  6  6 
14 28 52 52 52 52 21 21 21 21 21 32 25 27 25 26 21 21 21 21 
25 25 27 27 25 25 25 27 27 26 21 40 34 28 32 34 21  6  6  6 
33 34 44 36 32 41 34 52 28 35 21 36 32 25 33  6 21  6  6  6 
33 42 52 44 35 36 32 27 25 34 21 24 33 33  6  6 21  6  6  6 
34 44 44 44 40 25 34 44 32 34 21 32 33  6  6  6 21  6  6  6 
42 36 52 52 52 32 34 28 32 34 21  6  6  6  6  6 21  6  6  6 
44 28 52 28 52 32 33 25 33  6 21  6  6  6  6  6 21  6  6  6 
44 44 52 36 24 41 33 33  6  6 21  6  6  6  6 21 21  6  6  6 
52 52 44 28 35 44 32 33  6  6 21 21 21 21 21 21  6  6  6  6 
25 25 25 25 34 36 32  6  6  6  6  6  6  6  6  6  6  6  6  6 
