 9  9  9  9  9 10  4  5  5  4  4  4 16  9  9  9  9  9  9 13 
17 17 17 17  9 10  4  4  4  4  4  4  4  8  9  9  9  9  9  9 
 4  4  4  4  8  9  1  2  4  4  4  0  1  9  9 17 17  9  9  9 
 4  5  4  4  8  9  9  9  1  1  1  9  9 17 18  4  4  8  9  9 
 4  4  4  4  8  9  9  9  9  9  9 17 18  4  4  4  0  9  9  9 
 4  0  1  1  9  9  9 17 17 17 18  4  4  4  4  4 16 17 17 17 
 1  9  9  9  9  9 10 21 21 21 21 21 21 21 21 21 21 21 21 21 
13 13 13 13 13 13 13 21  0  2  4  4  4  4  4  0  1  1  1  1 
 9  9  9  9 17 17 10 21  8 10  4  4  5  4  4  8  9  9  9  9 
 9  9  9 10  4  4  3 21  8  9  2  4  4  4  0 14 14 14 14  9 
17 17  9  9  2  4  3 21  8  9 10  4  4  4  8 14 22 22 14  9 
 4  4 16  9  9  1 18 21  8  9  9  1 11  1  9 14 22 22 14  9 
 4  5  4  8  9 10 21 21  8  9  9 10  4  8  9 14 14 14 14  9 
 4  4  4  8 17 18 21  4  8  9  9 10  4  8  9 17 17 17 17  9 
 1  1  1 18  4  4 21  4  8 14  9  9 11 17 18  4  5  4  4  8 
 9  9 18  4  5  4 21  0  9  9  9 10  4  4  4  4  4  5  4  8 
 1
