13 13 13 13 13 13 13 13 13 13 13 13 13 13 13 13 13 13 13 13 
 9 18  4  4  5  8  9  9  9  9  6  6  6  9  9  9 12  9  9  9 
10  5  4  5  0  9 20  9 12  6  6  6  6  9 17 17 17 17 17  9 
 9  2  4  4 16  9  9  9  9  6  6  9  9 10  4  4  4  4  5  8 
 9  9  1  2  4  8  9  9  6  6  6  9 12 10  4  5  4  4  4  8 
17 17 17 17 11  9 20  9  6  6  6  9  9  9  2  5  4  4  0  9 
21 21 21 21 21  8  9 12  9  6  6 12  9  9  9  1  2  5  8  9 
 1  1  1  2 21  8  9  9  9  6  6  9 22 22 22  9  9  1  9  9 
 9 12  9 18 21 16 17 17  9  9  9  9 22 22 22  9 20  9 12  9 
 9 17 18  4 21 21 21 21  8  9 12  9 22 22 22  9  9 12  9  9 
18  4  4  0  1  1  2 21  8 12  9  9  9  9  9  9  9  9  9  9 
 5  5  4  8  9  9 10 21  8 17 17 17  9 12  9  9  9  6  6  6 
 4  4  4  8 20  9 10 21  3  4  4  5  8  9  9  9  6  6  6  6 
 2  5  4  8  9 20 10 21  3  4  5  0  9  9  6  6  6  6  6  6 
10  4  5  8  9  9 10 21  8  1  1  9  9  6  6  6  6  6  6  6 
 9  1  1  9 12  9 10 21  8  9  9  6  6  6  6  6  6  6  6  6 
